
1 img/doom2/ZZWOLF9.xpm
2 img/doom2/ZZWOLF2.xpm
3 img/doom2/ZZWOLF1.xpm
4 img/doom2/ZZWOLF3.xpm
5 img/doom2/ZCELL.xpm
6 img/doom2/PLAT1.xpm
7 img/doom2/ZZWOLF4.xpm
8 img/doom2/ZZWOLF11.xpm
: img/doom2/ZDOOR.xpm
d img/doom2/ZZWOLF10.xpm

F img/floor/floor_grey.xpm
C img/sky/sky.xpm 4

33333733337333733373337333733333
10000000000000000000000000000011
10000000000000000000000000000011
10000000004240000042400000000011
10000000000000000000000000000011
10000000000000000000000000000011
10000000000001111111111111111111
1000000000000000:000000001100001
1000001111111:111111111:11100005
10000010000110000000000000000001
100000100000:0000000000000000005
10000010000110000000000000000001
1000001111111:111111111:1111:111
11111111111100011111110001100011
11111111111100011111110001100011
11111111111100011111110N01100011
11111111111151511111111111151511

img/sprite/skeleton.xpm 0 2 6 28 1
img/sprite/armor.xpm 0 30 9 27 9
img/sprite/machinegun.xpm 1 9 7
img/sprite/bullet.xpm 1 7 7 7 5
img/sprite/chicken.xpm 1 30 6
img/sprite/silver_key.xpm 1 13 1

Enemy
img/enemy/enemy1.xpm 2 8
img/enemy/hitler.xpm 28 9
Reflect ON