
1 img/mobile/WALL025.xpm
: img/woodendoor.xpm

F img/floor/floor_grey.xpm
C img/sky/fullmoon.xpm

1111111111111111111111
1000000001000000000001
100000000:0000000000011111
10000000010000000000000001
10000000010000000000000001
10000000010000000000000001
10000000010000000000011111
1000000001000000000001
111:111111111:11111111
10000000010000000000001
1000000001000000000001
1000000001000000000001
1000000001000000000001
1000000001000000000001
1000000001000000000001
1000000001000000000001
1000000011000000000111
10000001 1000000001
1000001  1000000011
1000001  100000001
 111111  100000001
         100000W01
         100000001
         100000001
         111111111

img/sprite/silver_key.xpm 1 16 1
img/sprite/bullet.xpm 1 14 12 15 12 16 12
img/sprite/machinegun.xpm 1 14 11
img/sprite/chicken.xpm 0 4 6


Enemy
img/enemy/nazi.xpm 13 10
img/enemy/nazi.xpm 14 10
img/enemy/nazi.xpm 15 10
img/enemy/nazi.xpm 23 20
img/enemy/nazi.xpm 4 20

Reflect OFF