
1 img/doom2/ZZWOLF11.xpm
2 img/doom2/ZZWOLF2.xpm
6 img/doom2/PLAT1.xpm
: img/doom2/ZDOOR.xpm
d img/doom2/ZZWOLF10.xpm

F img/floor/floor_grey.xpm
C img/sky/sky3.xpm 4

11111111111111111111111111111111
10000000000000000000000000000011
10000000000000000000000000000011
10000000000000000000000000000011
10000000000000000000000000000011
10000000000000000000000000000011
10000000000001111111111111111111
1000000000000000:000000001100001
1000001111111:111111111:11100001
10000010000110000000000000000001
100000100000:0000000000E00000001
10000010000110000000000000000001
1000001111111:111111111:1111:111
11111111111100011111110001100011
11111111111100011111110001100011
11111111111100011111110001100011
11111111111111111111111111111111

img/sprite/chicken.xpm 1 30 6
Enemy
Reflect ON