
1 img/mobile/WALL025.xpm
: img/woodendoor.xpm

F img/floor/floor_grey.xpm
C img/sky/fullmoon.xpm

1111111111111111111111
1000000000000000000001
1000000000000000000001
1000000000000000000001
1000000000000000000001
1000000000000000000001
1000000000000000000001
1000000000000000000001
1000000000000000000001
1000000000000000000001
1000000000000000000001
1000000000000000000001
1000000000000000000001
1000000000000000000001
1000000000000000000001
1000000000000000000001
1000000000000000000001
1000000000000000000001
1000000000000000000001
1000000000000000000001
100000000N000000000001
1111111111111111111111

Enemy
img/enemy/nazi.xpm 1 1

Reflect OFF