1111111111111
1M010000000C1
10E0011111001
10PC11E000001
1111111111111