1111111111111
10010000000C1
1000011111001
100C11E0P0001
0111111111111