1111111111111
10010000000C001
100001111100001
100C11E0P00001
1111111111111