1111111111111
10P1000000001
1C00011111001
1000110000001
1111111111111