1111111111111
1001000K000C1
10M0011111001
1P0C11E000Z01
1111111111111