1111111111111111111111111111111111
1E00E0000000000C01000C000000000001
1010010100100000101001000000010101
101001001010101000100100E000010101
1P000E000C00C000C000000000000000C1
1P000CCCCC00C000C00000000P000000C1
1P00E0000C00C00PC0000P0001000000C1
1P0000000C00C000C010000000000000C1
1P0000000C00C0000000000000E00000C1
1111111111111111111111111111111111