111111111111111111111111
10010000000C000000000001
100001111100000000000001
100C11E0P000000000000001
111111111111111111111111