11111111111111111111111111111111111111
10010000000C00000000000000000000000001
10000111110000000000000000000000000001
100C11E0P00000000000000000000000000001
10010000000C00000000000000000000000001
10000111110000000000000000000000000001
100C11E0P00000000000000000000000000001
10010000000C00000000000000000000000001
10000111110000000000000000000000000001
100C11E0P00000000000000000000000000001
10010000000C00000000000000000000000001
10000111110000000000000000000000000001
100C11E0P00000000000000000000000000001
10010000000C00000000000000000000000001
10000111110000000000000000000000000001
100C11E0P00000000000000000000000000001
10010000000C00000000000000000000000001
10000111110000000000000000000000000001
100C11E0P00000000000000000000000000001
11111111111111111111111111111111111111